NO ./textures/wall_1.xpm
SO ./textures/wall_2.xpm
WE ./textures/wall_3.xpm
EA ./textures/wall_4.xpm

F 180,255,94
C 94,128,241

          1111111111111
      11111000000000001
      1000000000000000111111111
      1000000001110000000000001
      1000000001 10000000000011
      100000000111000000000001
      1000000000000000000000011
111111100000000000000000111111
1000000000000000000000001
1000000000N00000000000001
1000000000000000000000001
1111111111111111111111111
